BRG = "countries/Brzeg.txt"
SLE = "countries/Slezsko.txt"
GER = "countries/Germany.txt"
PAP = "countries/Papaj.txt"
###SILESIA###
MYS = "countries/Myslovitz.txt"
TYS = "countries/Tyskie.txt"
SBW = "countries/SilesianBoC.txt"
SOL = "countries/Solidarnosc.txt"
DUR = "countries/DURS.txt"
WOD = "countries/Wodzislaw.txt"
RBN = "countries/Rybnik.txt"
CIE = "countries/Cieszyn.txt"
CCH = "countries/Czestochowa.txt"
GLI = "countries/Gliwice.txt"
JSW = "countries/Jastrzebie.txt"
JAW = "countries/Jaworzno.txt"
KAT = "countries/Katowice.txt"
JWK = "countries/Lubliniec.txt"
BSK = "countries/Podbeskidzie.txt"
RAS = "countries/RAS.txt"
SOS = "countries/Sosnowiec.txt"
BED = "countries/Bedzin.txt"
SIE = "countries/Siewierz.txt"
BRZ = "countries/Truskolasy.txt"
ZAW = "countries/Zawiercie.txt"
ASG = "countries/57ASG.txt"
FER = "countries/Ferajna.txt"
TRC = "countries/Torcida.txt"
CHO = "countries/Chorzow.txt"
RUD = "countries/RudaSlaska.txt"
JUR = "countries/Jura.txt"
###DABROWA###
DGR = "countries/Dabrowa.txt"
DGA = "countries/Dabrowa2.txt"
ADM = "countries/Reden.txt"
DAR = "countries/Darzbor.txt"
FAR = "countries/Faraoni.txt"
HUT = "countries/Hutnicy.txt"
STG = "countries/Sztygarzy.txt"
STM = "countries/Strzemieszyce.txt"
SWK = "countries/Slawkow.txt"
###LODZ###
SAP = "countries/Skierniewice.txt"
WML = "countries/Lodz.txt"
KRS = "countries/Krosniewice.txt"
BBW = "countries/Belchatow.txt"
ZHP = "countries/ZHP.txt"
ZYD = "countries/Widzew.txt"
ZON = "countries/Zona.txt"
AMW = "countries/Wesołowska.txt"
KAR = "countries/Karliści.txt"
LKS = "countries/ŁKS.txt"
POG = "countries/LowcySkor.txt"
RUT = "countries/Rutkowski.txt"
TIG = "countries/TigerBonzo.txt"
RDM = "countries/ŁódzkiPiS.txt"

###BBW failstate###

ATM = "countries/AtomowaKrucjata.txt"
ONZ = "countries/UNOP.txt"

###ZHP CW###

GFL = "countries/Szare Lilijki.txt"
ZHR = "countries/ZHR.txt"

###LOWER SILESIA###
CZE = "countries/Klodzko.txt"
EKS = "countries/EK-Schlesien.txt"
TOU = "countries/Karpacz.txt"
MPK = "countries/MPK-Wroclaw.txt"
WRO = "countries/NorthWroclaw.txt"
ZUL = "countries/Walbrzych.txt"
RYB = "countries/Fanatycy.txt"
CYG = "countries/Cyganie.txt"
KGH = "countries/KGHM.txt"
COP = "countries/KGHMRevolt.txt"
BOG = "countries/Bogatynia.txt"
ECO = "countries/Eurokorpus.txt"
FEM = "countries/Femislavia.txt"
ANA = "countries/Alkohol.txt"
OLE = "countries/Olesnica.txt"
MNL = "countries/Piston.txt"

###OPOLE###
MNI = "countries/MniejszoscNiemiecka.txt"
OPO = "countries/Opole.txt"
LEH = "countries/Lehja.txt"
LCH = "countries/Lechici.txt"
WAN = "countries/Wandale_szydlowski.txt"
NYS = "countries/Nysa.txt"

###LUBUSZ###
PZL = "countries/PZL.txt"
KAM = "countries/Kampfgruppe.txt"
ZAG = "countries/Zagan.txt"
WIN = "countries/Winnygrod.txt"
MOT = "countries/Gorzow.txt"

###WEST POMERANIA###
JOM = "countries/Jomsborg.txt"
JAS = "countries/Jaszczurkowcy.txt"
SWI = "countries/Swinoujscie.txt"
USP = "countries/Polonia.txt"
STE = "countries/Szczecin.txt"
EKW = "countries/EK-Westpolen.txt"
STR = "countries/SilverTribe.txt"
KLB = "countries/Kolberg.txt"
NOR = "countries/NORDBAT.txt"
CHE = "countries/Chemiewerke.txt"
LIG = "countries/Liga.txt"
FRE = "countries/Asgaard.txt"
SNF = "countries/SlavicNationalFederation.txt"
BOR = "countries/Borne49.txt"

###GREATER POLAND###
PIL = "countries/Pila.txt"
SUS = "countries/Suski.txt"
NAC = "countries/Narodowcy.txt"
GNI = "countries/Gniezno.txt"
KNN = "countries/Konin.txt"
KLO = "countries/Kolo.txt"
FEL = "countries/TerraFelix.txt"
LIS = "countries/Lisowczycy.txt"
PRT = "countries/Pretorianie.txt"
ALP = "countries/Alfa.txt"
CAL = "countries/Kalisz.txt"
SYJ = "countries/Syjon.txt"
SLU = "countries/Slumsy.txt"
POZ = "countries/Poznan.txt"
ROZ = "countries/Rozbrat.txt"
ZBK = "countries/Zabka.txt"
LSZ = "countries/Leszno.txt"

###KUYAVIA-POMERANIA###
INO = "countries/Inowroclaw.txt"
HOR = "countries/Wloclawek.txt"
TOR = "countries/Torun.txt"
GRU = "countries/Grudziadz.txt"
KUJ = "countries/Kujawy.txt"
BYD = "countries/Bydgoszcz.txt"
PLK = "countries/Paluki.txt"
SWC = "countries/Swiecie.txt"
AMA = "countries/Amazonki.txt"
BRO = "countries/Brodnica.txt"
UFO = "countries/UFO.txt"
FMT = "countries/Koronowo.txt"
NED = "countries/Holandia.txt"
GAS = "countries/Zbrodnica.txt"
GSW = "countries/GRUSwiecie.txt"
GYP = "countries/DonWasyl.txt"
HOG = "countries/TheHoga.txt"
SKJ = "countries/Solec.txt"
MEM = "countries/Mentzen.txt"

###PODLACHIA###
SAN = "countries/Neosanacja.txt"
TAT = "countries/Tatarzy.txt"
BOM = "countries/Bombas.txt"
KON = "countries/Konon.txt"
BEL = "countries/Białoruś.txt"
LMZ = "countries/Łomża.txt"
UHL = "countries/Ułani.txt"
BRD = "countries/StrażGraniczna.txt"
ZAB = "countries/Zabłudów.txt"
AUG = "countries/Augustów.txt"
DAM = "countries/Kult.txt"
GRO = "countries/Gródek.txt"
DRO = "countries/Drohiczyn.txt"
TYK = "countries/Tykocin.txt"
ZAM = "countries/Zambrów.txt"
OSO = "countries/Osowiec.txt"
WIL = "countries/Wilkowyje.txt"
HMA = "countries/WysokieMazowieckie.txt"
SEI = "countries/Sejny.txt"
COL = "countries/Kolno.txt"
SUP = "countries/Supraśl.txt"
RAJ = "countries/Rajgród.txt"
TNO = "countries/Choroszcz.txt"
BAG = "countries/Bagno.txt"
MON = "countries/Monki.txt"
SAW = "countries/Sawice.txt"

###POMERANIA###
GAY = "countries/Slupsk.txt"
ARK = "countries/Arka.txt"
OWS = "countries/Owsiak.txt"
BOL = "countries/Bolek.txt"
GDA = "countries/Gdansk.txt"
KSZ = "countries/Kaszuby.txt"
HEL = "countries/Hel.txt"
CZL = "countries/Czluchow.txt" 
LOT = "countries/Lotos.txt"
KOR = "countries/Korsarz.txt"
MAL = "countries/Malbork.txt"
GDY = "countries/Gdynia.txt"
SOP = "countries/Sopot.txt"
LTS = "countries/KociewieSt.txt" 
LTT = "countries/KociewieTcz.txt"
KSC = "countries/KaszubiaCommonwealth.txt"
CHG = "countries/Chojnice.txt"
PGF = "countries/PomorskiGriff.txt" 
RLE = "countries/Lebork.txt"
MPR = "countries/PruszczGD.txt" 
TVI = "countries/TanViet.txt"
UGD = "countries/UniwersytetGdanski.txt"
SVG = "countries/SVG.txt"
WHR = "countries/Wejherowo.txt"
OIL = "countries/OilRig.txt"

###WARMIA-MASURIA###
ROS = "countries/Rosja.txt"
PZW = "countries/PZW.txt"
TEU = "countries/Krzyżacy.txt"
WRM = "countries/Warmia.txt"
PRU = "countries/Prusowie.txt"
ELB = "countries/Elblag.txt"
RMA = "countries/RusZone.txt"
MRG = "countries/Mragowo.txt"
GAL = "countries/Galindia.txt"
OLS = "countries/Olsztyn.txt"
LUB = "countries/Lubawa.txt"

###MAZOVIA###
PLO = "countries/LowcyWiedzm.txt"
SRP = "countries/Kasztelan.txt"
MAR = "countries/Mariawici.txt"
GOS = "countries/Gostynin.txt"
ORL = "countries/Płock.txt"
SDL = "countries/Siedlce.txt"
SAS = "countries/Sasin.txt"
POL = "countries/3RP.txt"
WOW = "countries/Macierewicz.txt"
MAF = "countries/Mafia.txt"
ZYR = "countries/Zyrardow.txt"
DUP = "countries/DUPA.txt"
WOL = "countries/Wolomin.txt"
AGR = "countries/Agrounia.txt"
LAS = "countries/Lasy.txt"
KUR = "countries/Kurpie.txt"
ZWK = "countries/Zawkrze.txt"
SCH = "countries/Sochaczew.txt"

###RADOMIA###
SKA = "countries/Skaryszew.txt"
RAD = "countries/Radom.txt"
GAR = "countries/Garwolin.txt"
SAT = "countries/Polsat.txt"
GRJ = "countries/Grojec.txt"
VRC = "countries/Warka.txt"
PAB = "countries/Piechocinski.txt"
AIR = "countries/Lotnicy.txt"
CZA = "countries/Czarnolas.txt"
SZY = "countries/Szydlowiec.txt"
APC = "countries/APC.txt"

###WARSAW###
BIE = "countries/Bielany.txt"
PLC = "countries/Policja.txt"
LEG = "countries/Legia.txt"
ZIE = "countries/Wawer.txt"
TVP = "countries/TVP.txt"
TRZ = "countries/Trzaskowski.txt"
JEH = "countries/Jehowi.txt"
CPK = "countries/CPK.txt"
WBG = "countries/WBGroup.txt"
GRD = "countries/Grodzisk.txt"
CZR = "countries/Czersk.txt"
ATO = "countries/POLATOM.txt"
URS = "countries/Ursus.txt"
OKE = "countries/Okecie.txt"
ITA = "countries/Wlochy.txt"
WAT = "countries/WAT.txt"
ZNP = "countries/ZNP.txt"
IPN = "countries/IPN.txt"
KOD = "countries/KOD.txt"
TVN = "countries/TVN.txt"
BLO = "countries/Bloki.txt"
WRC = "countries/WarsawCommonwealth.txt"
FSO = "countries/FSO.txt"
WRS = "countries/FreeWarsaw.txt"
KCZ = "countries/Zoliborz.txt"

###ZERO###
PRK = "countries/Ziobro.txt"

###HOLY CROSS###
SND = "countries/Sandomierz.txt"
STA = "countries/Starachowice.txt"
STO = "countries/Stonoga.txt"
NSZ = "countries/BrygadaSwietokrzyska.txt"
NRA = "countries/GwardiaLudowa.txt"
KEL = "countries/WaffenSS.txt"
KIE = "countries/Kielce.txt"
OPT = "countries/Opatów.txt"
OSS = "countries/Ostrowiec.txt"
ETS = "countries/STAR.txt"

###LESSER POLAND###
KRK = "countries/Krakow.txt"
NHT = "countries/NowaHuta.txt"
MSL = "countries/Myslenice.txt"
UMN = "countries/Wieliczka.txt"
SKW = "countries/Skawina.txt"
BOH = "countries/Bochnia.txt"
GUR = "countries/Podhale.txt"
SCZ = "countries/NowySacz.txt"
TRN = "countries/Tarnow.txt"
TRW = "countries/Tarnow2.txt"
LEM = "countries/Lemkowie.txt"
OSW = "countries/Oswiecim.txt"
WDW = "countries/Wadowice.txt"
KRA = "countries/Gibała.txt"
BRK = "countries/Bekowicz.txt"
WND = "countries/Wanda.txt"
UJG = "countries/UJ.txt"
AGH = "countries/AGH.txt"
HAB = "countries/Makłowicz.txt"
TSZ = "countries/Teschin.txt"
BBA = "countries/BielskoBiala.txt"
WYM = "countries/Wymysou.txt"
NPL = "countries/Niepolomice.txt"
BRS = "countries/Brzesko.txt"
ZKP = "countries/Zakopane.txt"
CHW = "countries/Chrzanow.txt"
ZGR = "countries/Zagorzanie.txt"
TYM = "countries/Tymbark.txt"
OSP = "countries/StrazPozarna.txt"
PRO = "countries/Kosciuszkowcy.txt"
ROK = "countries/Jaskiniowcy.txt"
GRB = "countries/Garibaldi.txt"
BGR = "countries/Bozogrobcy.txt"

###OTHER COUNTRIES###
AUT = "countries/Austria.txt"
MOR = "countries/Morawy.txt"
CZH = "countries/Czechy.txt"
DEN = "countries/Denmark.txt"
HUN = "countries/Hungary.txt"
LIT = "countries/Lithuania.txt"
ROM = "countries/Romania.txt"
SVK = "countries/Slovakia.txt"
SWE = "countries/Sweden.txt"
UKR = "countries/Ukraine.txt"
RUS = "countries/FR.txt"
TSB = "countries/TajemniczySprzedawcaBroni.txt"
USA = "countries/USA.txt"
CHI = "countries/China.txt"
FRA = "countries/France.txt"
ENG = "countries/DisunitedKingdom.txt"

###SUBCARPATHIA###
RZE = "countries/Rzeszow.txt"
CHR = "countries/Natanek.txt"
UPA = "countries/UPA.txt"
KOZ = "countries/Sicz.txt"
BSC = "countries/Bieszczady.txt"
KRO = "countries/Krosno.txt"
TAR = "countries/Tarnobrzeg.txt"
MIE = "countries/Mielec.txt"
DBI = "countries/Debica.txt"
JSO = "countries/Jaslo.txt"
STL = "countries/StalowaWola.txt"
LEZ = "countries/Lezajsk.txt"
LCZ = "countries/Lubaczow.txt"
KOL = "countries/Kolbuszowa.txt"
ANC = "countries/Anarchia.txt"
NIS = "countries/Nisko.txt"
BEX = "countries/Sanok.txt"
LGP = "countries/LegionPolski.txt"
UHR = "countries/UkrainaHumanitarna.txt"

###LUBELSKIE###
CRN = "countries/Lublin.txt"
PUL = "countries/Pulawy.txt"
KSN = "countries/Krasnik.txt"
SWD = "countries/Swidnik.txt"
ZUK = "countries/Chelm.txt"
BPD = "countries/BialaPodlaska.txt"
BIL = "countries/Bilgoraj.txt"
TEN = "countries/Sznuk.txt"
LEN = "countries/Ledzianie.txt"
RMF = "countries/RuskaMafia.txt"
LBW = "countries/Bogdanka.txt"
KST = "countries/Krasnystaw.txt"
PLB = "countries/PartyzanciLubelszczyzny.txt"
ORD = "countries/Zamosc.txt"
RPP = "countries/PoludniowePodlasie.txt"
AZO = "countries/Azoty.txt"
###EK-COLLAPSE###
WRT = "countries/Wartheland.txt"
KOS = "countries/Koslin.txt"
POM = "countries/Pommern.txt"
BRE = "countries/Breslau.txt"
KES = "countries/Kesselberg.txt"

### BARBARIANS
JUT = "countries/Jutowie.txt"
WIZ = "countries/Wizygoci.txt"
OST = "countries/Ostrogoci.txt"
FRK = "countries/Frankowie.txt"
VAN = "countries/Wandalowie.txt"
HNN = "countries/Hunowie.txt"
SCY = "countries/Scytowie.txt"
AES = "countries/Aestowie.txt"
SAX = "countries/Sasi.txt"
SPA = "countries/Spartakus.txt"


### VOIVODESHIPS
HOL = "countries/HolyCross.txt"
MNT = "countries/Beskidzkie.txt"
MPL = "countries/Malopolskie.txt"
PDK = "countries/Podkarpackie.txt"
LBL = "countries/Lubelskie.txt"
RDS = "countries/Radomskie.txt"
CAP = "countries/Stoleczne.txt"
PDL = "countries/Podlaskie.txt"
WIM = "countries/WarminskoMazurskie.txt"
MAZ = "countries/Polnocnomazowieckie.txt"
KJP = "countries/Kujawskie.txt"
LDZ = "countries/Lodzkie.txt"
ZGJ = "countries/ZaglebieJura.txt"
GSL = "countries/Gornoslaskie.txt"
NSK = "countries/Nyskie.txt"
LGN = "countries/Legnickie.txt"
DSL = "countries/Wroclawskie.txt"
KAL = "countries/Kaliskie.txt"
PZN = "countries/Poznanskie.txt"
ZPM = "countries/Zachodniopomorskie.txt"
PMR = "countries/Pomorskie.txt"